1Tttuuu1111111111
111p0001luc111111
1111p001ld1111111
11111p01r11111111
111111ppd11111111
11111111111111111