1111111111111111111l
11111d00l1111111111l
1111d0110l111111111l
111d011110l11111111l
1000111111000111111l
1111111111111111111l