11111111111111
11111111111111
11r00000l11111
11010101011111
100U0U0U000111
11111111111111