111111111111111111111
11111110u111111111111
11111utt0111111111111
11111r11r111111111111
11tttd11dttT111111111
111111111111111111111