111111111111111111111111011100010111111l
111111111111111111111111011101010111111l
111111111111111111111111000100010001111l
111111111111111111111111111111111111111l
1tttttttTttttttttttttttttttttttttttttt1l
111111111111111111111111111111111111111l