111111111111111111111111011100010111111l
111111111111111111111111011101010111111l
111111111111111111111111ppp1ppp1ppp1111l
111111111111111111111111111111111111111l
1cttppttTppttttpttppttttppttttptttpttt1l
111111111111111111111111111111111111111l