1111111111111111111l
111110pp01111111111l
1111001100111111111l
1110011110011111111l
1Ttt11111100c111111l
1111111111111111111l