11111111111111
11111111111111
11upupupr11111
11r1r1r1r11111
1T00000000c111
11111111111111