1111111111111111111l
11111uttu1111111111l
1111ud11du111111111l
111ud1111du11111111l
1Ttd111111dtt111111l
1111111111111111111l