10010000000D00011111111111
11011111111010011111111111
1101111111r010011111111111
11011111111011011111111111
11000000000000011111111111
11111111111111111111111111