111111111111111
100001001111111
11U0U1l11111111
1D1R1DL11111111
10U000011111111
111111111111111