11111111111111
11111111111111
11000000000111
11010110000111
100UUU000U0011
11111111111111