11111111111111
10000000011111
11010110111111
11010110111111
11010110111111
11010110111111