11111111111111
1tuuu10c11111
11101l01111111
10tdt001111111
1T111pp1111111
11111111111111