1111111111111111
1111111001111111
11000L1101111111
1111111111111111
100110000L111111
1111111111111111