111111111111111111111
11111111u111111111111
11111upd0111111111111
11111r11r111111111111
11cppd11ptpt111111111
111111111111111111111