11111111111111
11111111111111
110p0pp0000111
11010110000111
1c000000000011
11111111111111