111111111111111111111
11111111d111111111111
11111d000111111111111
111110110111111111111
11000u110000111111111
111111111111111111111