1Ttuuuu1111111111
111d0001lut111111
1111d001ld1111111
11111d01r11111111
111111dtd11111111
11111111111111111