10000001111111111
111r000100c111111
1111r001001111111
11111r01L11111111
111111r0L11111111
11111111111111111